S....W............
.....W............
....WW............
...WW.............
WW...WW...........
WWWWWW............
......WW..........
.........WWWWWWWWW
..................
.................E
