S...WW..............
..W..W..............
...W.W..............
...W.W..............
....WW......WW......
...........WW..WWWWW
..........WW..W....E