S....W............
.....W............
....WW............
...WW.............
WW...WW...........
WWWWWW............
......WW..........
.........WWWWWWWWW
..................
..................
..................
WWWWWWWWWWWWWWWWW.
.................W
.WWWWWWWWWWWWWWWWW
.................E
